hi, how are you doing?	i'm fine. how about yourself?
i'm fine. how about yourself?	i'm pretty good. thanks for asking.
i'm pretty good. thanks for asking.	no problem. so how have you been?
no problem. so how have you been?	i've been great. what about you?
i've been great. what about you?	i've been good. i'm in school right now.
i've been good. i'm in school right now.	what school do you go to?
what school do you go to?	i go to pcc.
i go to pcc.	do you like it there?
do you like it there?	it's okay. it's a really big campus.
it's okay. it's a really big campus.	good luck with school.
good luck with school.	thank you very much.
how's it going?	i'm doing well. how about you?
i'm doing well. how about you?	never better, thanks.
never better, thanks.	so how have you been lately?
so how have you been lately?	i've actually been pretty good. you?
i've actually been pretty good. you?	i'm actually in school right now.
i'm actually in school right now.	which school do you attend?
which school do you attend?	i'm attending pcc right now.
i'm attending pcc right now.	are you enjoying it there?
are you enjoying it there?	it's not bad. there are a lot of people there.
it's not bad. there are a lot of people there.	good luck with that.
good luck with that.	thanks.
how are you doing today?	i'm doing great. what about you?
i'm doing great. what about you?	i'm absolutely lovely, thank you.
i'm absolutely lovely, thank you.	everything's been good with you?
everything's been good with you?	i haven't been better. how about yourself?
i haven't been better. how about yourself?	i started school recently.
i started school recently.	where are you going to school?
where are you going to school?	i'm going to pcc.
i'm going to pcc.	how do you like it so far?
how do you like it so far?	i like it so far. my classes are pretty good right now.
i like it so far. my classes are pretty good right now.	i wish you luck.
it's an ugly day today.	i know. i think it may rain.
i know. i think it may rain.	it's the middle of summer, it shouldn't rain today.
it's the middle of summer, it shouldn't rain today.	that would be weird.
that would be weird.	yeah, especially since it's ninety degrees outside.
yeah, especially since it's ninety degrees outside.	i know, it would be horrible if it rained and it was hot outside.
i know, it would be horrible if it rained and it was hot outside.	yes, it would be. 
yes, it would be. 	i really wish it wasn't so hot every day. 
i really wish it wasn't so hot every day. 	me too. i can't wait until winter.
me too. i can't wait until winter.	i like winter too, but sometimes it gets too cold.
i like winter too, but sometimes it gets too cold.	i'd rather be cold than hot.
i'd rather be cold than hot.	me too.
it doesn't look very nice outside today.	you're right. i think it's going to rain later.
you're right. i think it's going to rain later.	in the middle of the summer, it shouldn't be raining.
in the middle of the summer, it shouldn't be raining.	that wouldn't seem right.
that wouldn't seem right.	considering that it's over ninety degrees outside, that would be weird.
considering that it's over ninety degrees outside, that would be weird.	exactly, it wouldn't be nice if it started raining. it's too hot.
exactly, it wouldn't be nice if it started raining. it's too hot.	i know, you're absolutely right.
i know, you're absolutely right.	i wish it would cool off one day.
i wish it would cool off one day.	that's how i feel, i want winter to come soon.
that's how i feel, i want winter to come soon.	i enjoy the winter, but it gets really cold sometimes.
i enjoy the winter, but it gets really cold sometimes.	i know what you mean, but i'd rather be cold than hot.
i know what you mean, but i'd rather be cold than hot.	that's exactly how i feel.
i wish it was a nicer day today.	that is true. i hope it doesn't rain.
that is true. i hope it doesn't rain.	it wouldn't rain in the middle of the summer.
it wouldn't rain in the middle of the summer.	it wouldn't seem right if it started raining right now.
it wouldn't seem right if it started raining right now.	it would be weird if it started raining in ninety degree weather.
it would be weird if it started raining in ninety degree weather.	any rain right now would be pointless.
any rain right now would be pointless.	that's right, it really would be.
that's right, it really would be.	i want it to cool down some.
i want it to cool down some.	i know what you mean, i can't wait until it's winter.
i know what you mean, i can't wait until it's winter.	winter is great. i wish it didn't get so cold sometimes though.
winter is great. i wish it didn't get so cold sometimes though.	i would rather deal with the winter than the summer.
it's such a nice day.	yes, it is.
yes, it is.	it looks like it may rain soon.
it looks like it may rain soon.	yes, and i hope that it does.
yes, and i hope that it does.	why is that?
why is that?	i really love how rain clears the air.
i really love how rain clears the air.	me too. it always smells so fresh after it rains.
me too. it always smells so fresh after it rains.	yes, but i love the night air after it rains.
yes, but i love the night air after it rains.	really? why is it?
really? why is it?	because you can see the stars perfectly.
because you can see the stars perfectly.	i really hope it rains today.
i really hope it rains today.	yeah, me too.
isn't it a nice day?	it really is.
it really is.	it seems that it may rain today.
it seems that it may rain today.	hopefully it will.
hopefully it will.	how come?
how come?	i like how clear the sky gets after it rains.
i like how clear the sky gets after it rains.	i feel the same way. it smells so good after it rains.
i feel the same way. it smells so good after it rains.	i especially love the night air when it rains.
i especially love the night air when it rains.	really? why?
really? why?	the stars look so much closer after it rains.
the stars look so much closer after it rains.	i really want it to rain today.
i really want it to rain today.	yeah, so do i.
don't you think it's nice out?	yes, i think so too.
yes, i think so too.	i think that it's going to rain.
i think that it's going to rain.	i hope that it does rain.
i hope that it does rain.	you like the rain?
you like the rain?	the sky looks so clean after it rains. i love it.
the sky looks so clean after it rains. i love it.	i understand. rain does make it smell cleaner.
i understand. rain does make it smell cleaner.	i love most how it is at night after it rains.
i love most how it is at night after it rains.	how come?
how come?	you can see the stars so much more clearly after it rains.
you can see the stars so much more clearly after it rains.	i would love for it to rain today.
i really want to go to the beach this weekend.	that sounds like fun. what's the weather going to be like?
that sounds like fun. what's the weather going to be like?	i heard that it's going to be warm this weekend.
i heard that it's going to be warm this weekend.	is it going to be perfect beach weather?
is it going to be perfect beach weather?	i believe so.
i believe so.	good. i hope it doesn't cool off this weekend.
good. i hope it doesn't cool off this weekend.	i know. i really want to go to the beach.
i know. i really want to go to the beach.	but you know that california weather is really unpredictable.
but you know that california weather is really unpredictable.	you're right. one minute it's hot, and then the next minute it's cold.
you're right. one minute it's hot, and then the next minute it's cold.	i really wish the weather would just stay the same.
i really wish the weather would just stay the same.	i do too. that way we can have our activities planned ahead of time.
i do too. that way we can have our activities planned ahead of time.	yeah, that would make things a lot easier.
i would like to take a trip to the beach this weekend.	a trip to the beach would be fun. how is the weather going to be?
a trip to the beach would be fun. how is the weather going to be?	the forecast says that it will be warm on the weekend.
the forecast says that it will be warm on the weekend.	so do you think it'll be perfect weather for the beach?
so do you think it'll be perfect weather for the beach?	it sounds like it will be.
it sounds like it will be.	i really hope it doesn't get cold.
i really hope it doesn't get cold.	that would ruin things, i want to go so badly.
that would ruin things, i want to go so badly.	the weather in california is unpredictable, so you never know.
the weather in california is unpredictable, so you never know.	that is true. the weather is constantly changing.
that is true. the weather is constantly changing.	it would be nice if the weather would never change.
it would be nice if the weather would never change.	that would be great, then we could plan things sooner.
that would be great, then we could plan things sooner.	true. predictable weather would make life easier.
it would be nice to go to the beach sometime this weekend.	what's the weather going to be like? i may want to go too.
what's the weather going to be like? i may want to go too.	the weather this weekend is supposed to be warm.
the weather this weekend is supposed to be warm.	will it be good beach weather?
will it be good beach weather?	i think it will be.
i think it will be.	it wouldn't be good if it got cold this weekend.
it wouldn't be good if it got cold this weekend.	i want this trip to be perfect, i hope it stays warm.
i want this trip to be perfect, i hope it stays warm.	this california weather is so uncertain, it's impossible to know what'll happen.
this california weather is so uncertain, it's impossible to know what'll happen.	i know. every day the weather seems different.
i know. every day the weather seems different.	i would love it if it wasn't always so unpredictable.
i would love it if it wasn't always so unpredictable.	that would make it easier for us to make plans.
hello, may i speak to alice please?	this is she. how's it going?
this is she. how's it going?	i've been trying to call you all day.
i've been trying to call you all day.	sorry about that. i was cleaning up.
sorry about that. i was cleaning up.	it's okay.
it's okay.	so what were you calling me about?
so what were you calling me about?	oh, i just wanted to see if you wanted to hang out tomorrow.
oh, i just wanted to see if you wanted to hang out tomorrow.	sure, what did you want to do?
sure, what did you want to do?	maybe we can go see a movie or something.
maybe we can go see a movie or something.	that sounds like fun. let's do it.
that sounds like fun. let's do it.	i'll see you tomorrow then.
i'll see you tomorrow then.	see you then. goodbye.
hi, how are you. is alice there?	speaking. what's up?
speaking. what's up?	why haven't you answered the phone?
why haven't you answered the phone?	my bad, i had chores to do.
my bad, i had chores to do.	that's all right.
that's all right.	what was the reason for your call?
what was the reason for your call?	i want to do something tomorrow with you.
i want to do something tomorrow with you.	sounds good. what did you have in mind?
sounds good. what did you have in mind?	i was thinking about seeing a movie.
i was thinking about seeing a movie.	okay, let's go see a movie.
okay, let's go see a movie.	until then.
until then.	talk to you later.
is alice available?	you're talking to her.
you're talking to her.	i've called you a hundred times today.
i've called you a hundred times today.	i was busy doing something. i apologize.
i was busy doing something. i apologize.	no problem.
no problem.	did you need something?
did you need something?	do you want to do something tomorrow?
do you want to do something tomorrow?	is there somewhere special you wanted to go?
is there somewhere special you wanted to go?	how about a movie?
how about a movie?	a movie sounds good.
a movie sounds good.	call me tomorrow then.
have you seen the new girl in school?	no, i haven't.
no, i haven't.	she's really pretty.
she's really pretty.	describe her to me.
describe her to me.	she's not too tall.
she's not too tall.	well, how tall is she?
well, how tall is she?	she's about five feet even.
she's about five feet even.	what does she look like, though?
what does she look like, though?	she has pretty light brown eyes.
she has pretty light brown eyes.	i may know which girl you're talking about.
i may know which girl you're talking about.	so you have seen her around?
so you have seen her around?	yes, i have.
there's a new girl in school, have you seen her yet?	i haven't seen her yet.
i haven't seen her yet.	i think that she is very pretty.
i think that she is very pretty.	tell me how she looks.
tell me how she looks.	she's kind of short.
she's kind of short.	what height is she?
what height is she?	she's probably about five feet.
she's probably about five feet.	that's nice, but tell me what she looks like.
that's nice, but tell me what she looks like.	the first thing i noticed was her beautiful brown eyes.
the first thing i noticed was her beautiful brown eyes.	i think i might've bumped into her before.
i think i might've bumped into her before.	are you telling me that you've seen her before?
are you telling me that you've seen her before?	i believe so.
have you met the new girl?	no. have you?
 party.
next saturday, i'm going to have a party.	oh, really?
oh, really?	you are coming?
you are coming?	probably not.
probably not.	why is that?
why is that?	i don't feel like going.
i don't feel like going.	why not?
why not?	i really can't stand going to parties.
i really can't stand going to parties.	i understand, i guess.
i understand, i guess.	sorry about that.
what's happening?	not a lot, what about you?
not a lot, what about you?	i'm having a party next saturday.
i'm having a party next saturday.	that's nice.
that's nice.	are you going to be there?
are you going to be there?	i don't think so.
i don't think so.	is there a reason why?
is there a reason why?	i just really don't want to go.
i just really don't want to go.	how come?
how come?	i don't really like parties.
i don't really like parties.	i wish you would go, but that's okay.
what's up?	nothing much, what's going on?
nothing much, what's going on?	i'm having a party this friday.
i'm having a party this friday.	oh, really? that's nice.
oh, really? that's nice.	i wanted to see if you wanted to come.
i wanted to see if you wanted to come.	this friday? sorry, i already have plans.
this friday? sorry, i already have plans.	doing what?
doing what?	i'm going to dinner with my family.
i'm going to dinner with my family.	i really wanted you to come, but i understand.
i really wanted you to come, but i understand.	yeah, maybe next time.
yeah, maybe next time.	i'll hold you to that.
i'll hold you to that.	sounds like a plan.
hey, what's good with you?	not a lot. what about you?
not a lot. what about you?	i'm throwing a party on friday.
i'm throwing a party on friday.	that sounds like fun.
that sounds like fun.	do you think you can come?
do you think you can come?	i'm sorry. i'm already doing something this friday.
i'm sorry. i'm already doing something this friday.	what are you going to be doing?
what are you going to be doing?	my family and i are going to dinner.
my family and i are going to dinner.	i was hoping you would come.
i was hoping you would come.	i'll definitely try to make it the next time.
i'll definitely try to make it the next time.	i'd better see you there.
i'd better see you there.	all right. i'll see you next time.
what's going on?	nothing really. how about you?
nothing really. how about you?	a lot, like the party i'm having on friday.
a lot, like the party i'm having on friday.	well, that's cool.
well, that's cool.	will you be able to make it?
will you be able to make it?	i'm busy this friday. i'm sorry.
i'm busy this friday. i'm sorry.	what do you have to do?
what do you have to do?	i'm having dinner with my family
i'm having dinner with my family	maybe you can come next time.
maybe you can come next time.	i'll make sure and come to your next party.
i'll make sure and come to your next party.	i'll look for you at my next party.
it was nice talking to you.	why are you trying to rush me off the phone?
why are you trying to rush me off the phone?	i really have to go.
i really have to go.	why? i still wanted to talk to you.
why? i still wanted to talk to you.	i have things to do.
i have things to do.	like what?
like what?	don't be nosey.
don't be nosey.	i'm not. i just want to know.
i'm not. i just want to know.	well, it's really none of your business.
well, it's really none of your business.	that's harsh.
that's harsh.	i'm sorry, but i have to go.
i'm sorry, but i have to go.	fine.
i've enjoyed conversing with you.	is there a reason why you're trying to get off the phone so fast?
is there a reason why you're trying to get off the phone so fast?	i've got to go.
i've got to go.	i wasn't done talking to you.
i wasn't done talking to you.	i have to do some things, and besides, it's not polite to be nosey.
i have to do some things, and besides, it's not polite to be nosey.	i'm not being nosey. i'm just asking.
i'm not being nosey. i'm just asking.	i really don't think it's any of your business.
i really don't think it's any of your business.	that's not nice.
that's not nice.	i apologize, but i'm getting off the phone now.
i apologize, but i'm getting off the phone now.	okay.
i'll talk to you later.	what's the rush?
what's the rush?	i have to get off the phone now.
i have to get off the phone now.	i'm not ready to get off the phone with you.
i'm not ready to get off the phone with you.	there are other things i need to take care of.
there are other things i need to take care of.	what is it that you need to do? 
what is it that you need to do? 	please don't be nosey.
please don't be nosey.	i'm not being nosey, it's just a question.
i'm not being nosey, it's just a question.	you don't need to worry about that.
you don't need to worry about that.	that was mean to say.
that was mean to say.	i am very sorry, but i must go.
well, it was nice talking to you.	it was nice talking to you too.
it was nice talking to you too.	we should really hang out again.
we should really hang out again.	that would be fun.
that would be fun.	where do you want to go?
where do you want to go?	i think we should go out to eat.
i think we should go out to eat.	that sounds good.
that sounds good.	all right, so i'll see you then.
all right, so i'll see you then.	i'll call you later.
i'll call you later.	okay, i'll talk to you later then.
okay, i'll talk to you later then.	see you later.
see you later.	bye.
i enjoyed talking to you.	i enjoyed talking to you too.
i enjoyed talking to you too.	we should hang out some time.
we should hang out some time.	i think that would be nice.
i think that would be nice.	is there anything you would like to do next time?
is there anything you would like to do next time?	do you want to go out to eat?
do you want to go out to eat?	i'd like that.
i'd like that.	so i'll see you next time.
so i'll see you next time.	i'm going to call you soon. 
i'm going to call you soon. 	i'll talk to you later.
i'll talk to you later.	see you soon.
see you soon.	goodbye.
i had fun talking to you.	it was really nice talking to you also.
it was really nice talking to you also.	i think we should really do something sometime.
i think we should really do something sometime.	that should be loads of fun.
that should be loads of fun.	what do you want to do next time?
what do you want to do next time?	would you like to go to dinner or something?
would you like to go to dinner or something?	yeah, let's do that.
yeah, let's do that.	okay, until next time then.
okay, until next time then.	i'll call you so we can set that up.
i'll call you so we can set that up.	talk to you then.
talk to you then.	all right, see you.
where do you live?	i live in pasadena.
i live in pasadena.	where is pasadena?
where is pasadena?	it's in california.
it's in california.	is it in northern california?
is it in northern california?	no. it's in southern california.
no. it's in southern california.	is pasadena a big city?
is pasadena a big city?	it's pretty big.
it's pretty big.	how big is "pretty big"?
how big is "pretty big"?	it has about 140,000 people.
it has about 140,000 people.	how big is los angeles?
how big is los angeles?	it has about 3 million people.
do you have a car?	yes, i do.
yes, i do.	what kind of car do you have?
what kind of car do you have?	i have a honda.
i have a honda.	is it new?
is it new?	it was new in 2003.
it was new in 2003.	so, it's pretty old now.
so, it's pretty old now.	yes, it is. but it still looks good.
yes, it is. but it still looks good.	do you take good care of it?
do you take good care of it?	oh, yes. i wash it once a week.
oh, yes. i wash it once a week.	do you change the oil?
do you change the oil?	my mechanic changes the oil twice a year.
do you have a girlfriend?	no, i don't. do you?
